00000000000000000
02000000000111100
01011110001000100
01010011111111100
01010010000000110
01010010111100110
01110010100111110
01000011100000010
01010000100000010
01010000101110010
01110000111011000
00011101001001110
00010101111000100
01110100001000100
01000111110111100
01000000010100000
01111111110111130
00000000000000000
